+--+--+--+--+--+
aaaa++ggg++++++|
+++c+-e+g-+--+-|
|++d|-e+g-+--+-|
+++e--e-g+--+--+
|++fghfgh+--+--+
+--h-+--+--+-E-|
|E+d+|--|++++++|
++|e+|E-+++++++|
|EbcdabcdsadsE+|
+--+--+--+--+--+